A	AH
A(2)	EY
ALL	AO L
AMAZON	AE M AH Z AA N
APPS	AE P S
BACK	B AE K
BOX	B AA K S
D	D IY
FIVE	F AY V
FORWARD	F AO R W ER D
FULL	F UH L
GO	G OW
H	EY CH
HALF	HH AE F
HOTSTAR	HH AA T S T AA R
HUNGAMA	HH AH N G AH M AH
I	AY
LEFT	L EH F T
M	EH M
MOVE	M UW V
MOVIE	M UW V IY
NETFLIX	N EH T L AH K S
ONE	W AH N
ONE(2)	HH W AH N
OPEN	OW P AH N
PAUSE	P AO Z
PLAY	P L EY
PRIME	P R AY M
RIGHT	R AY T
SEARCH	S ER CH
SPEED	S P IY D
STOP	S T AA P
SWITCH	S W IH CH
T	T IY
THREE	TH R IY
TO	T UW
TO(2)	T IH
TO(3)	T AH
TOP	T AA P
TOP(2)	T AO P
TWO	T UW
V	V IY
VOOT	V UW T
YOUTUBE	Y UW T UW B
ZEE	Z IY
